date,description,amount,currency,balance
2024-01-15,Salary Deposit,2500.00,USD,3500.00
2024-01-16,Grocery Store,-85.50,USD,3414.50
2024-01-17,Gas Station,-45.00,USD,3369.50
15/01/2024,Online Shopping,-125.75,USD,3243.75
16/01/2024,Coffee Shop,-12.50,USD,3231.25
2024-01-18,Bank Transfer,500.00,USD,3731.25
2024-01-19,Utility Bill,-150.00,USD,3581.25
2024-01-20,Restaurant,-68.90,USD,3512.35